10 10
00W0000C0G
WW0Wc00W00
WW00WWBWWW
WWWW0W0WbW
W0W00W000W
W00000000W
WW0W00000W
0WAW00000W
0W0WWWWWWW
S000a00000