10 20
00W0000C0G
WW0Wc00W00
WW00WWBWWW
WWWW0W0WbW
W0W00W000W
W0000000WW
WWWWWWWAWW
0Wa000000W
0W0WFWWWWW
WWWW0WWWWW
WWWW0WWWWW
WWWWfWWWWW
WWWW0WWWWW
WWWW0WWWWW
WWWW0WWWWW
WWWWEWWWWW
WWWW0WWWWW
WWWWeWWWWW
WWWW0WWWWW
S0d0DWWWWW