29 5
00000000000000000000000000000
0W0W0W00WW0WWW0WWW00WWW00W0W0
0W0W0W0W0000W00W0W00W0W000W00
00W00W00WW00W00WWW00W00W00W00
00000000000000000000000000000
